940010050
780000009
015907800
000480307
060090040
804032000
009608170
100000084
070050023