000700500
150340086
080596041
600900000
041000650
000005004
230478060
410059072
006003000