160020700
700900020
000500041
007060050
009050100
080010300
850007000
020005009
001040038