000780051
000300208
200005040
300008600
801906305
007500002
060800009
903001000
510097000