020095007
045032160
070060040
490000700
003000200
007000096
030070050
061320470
700650020