000005004
040371690
070020301
006080910
004010700
087060400
705040030
063152040
400900000