069050200
000000081
400300060
400001809
050804020
201500070
030006002
720000000
008010340
