003980720
900001000
007460100
670050800
010000070
008020051
006018500
000500007
095036200