069200000
000008200
210405603
000002038
702000906
580600000
603508029
005900000
000007560